{
  "name": "1. In the beninging",
  "rising_speed": 0,
  "environment": [
    [1,1,1,1,1,1,1,1,1,1,1,1,1,1,1],
    [1,0,0,0,0,0,0,0,0,0,0,0,0,0,1],
    [1,0,0,0,0,0,0,0,0,0,0,0,0,0,1],
    [1,0,0,0,0,0,0,0,0,0,0,0,0,0,1],
    [1,0,0,0,0,0,0,0,0,0,0,0,0,0,1],
    [1,0,0,0,0,0,0,0,0,0,0,0,0,0,1],
    [1,0,0,0,0,0,0,0,0,0,0,0,0,0,1],
    [1,0,0,0,0,0,0,0,0,0,0,0,0,0,1],
    [1,0,0,0,0,0,1,1,0,0,0,0,0,0,1],
    [1,0,0,0,0,0,1,1,1,1,0,3,0,0,1],
    [1,0,0,0,0,0,0,1,1,1,1,1,1,1,1],
    [1,0,0,0,0,0,0,0,0,0,0,1,1,1,1],
    [1,0,0,0,0,0,0,0,0,0,0,0,0,0,1],
    [1,1,1,1,1,1,0,0,0,0,0,0,0,0,1],
    [1,1,1,1,1,1,1,1,1,1,0,0,0,0,1],
    [1,0,0,0,0,0,0,0,0,0,0,0,0,0,1],
    [1,0,0,0,0,0,0,0,0,0,0,0,1,1,1],
    [1,0,0,0,0,0,0,0,1,1,1,1,1,1,1],
    [1,0,2,0,0,0,1,1,1,1,1,1,1,1,1],
    [1,1,1,1,1,1,1,1,1,1,1,1,1,1,1]
  ]
}