{
  "name": "2. Jump on",
  "rising_speed": 0,
  "environment": [
    [0,0,0,0,0,0,0,0,0,0,0,0,0,0,0],
    [0,0,0,0,0,0,0,0,0,0,0,0,0,0,0],
    [0,0,0,0,0,0,0,0,0,0,0,0,0,0,0],
    [0,0,0,0,0,0,0,0,0,0,0,0,0,0,0],
    [0,0,0,0,0,0,0,0,0,0,0,0,0,0,0],
    [1,0,0,0,0,0,0,0,0,0,0,0,0,0,0],
    [1,1,0,0,0,0,0,0,0,0,0,0,3,0,0],
    [1,1,1,1,0,0,0,0,0,0,0,1,1,1,0],
    [1,1,1,1,1,0,0,0,0,1,1,1,1,1,1],
    [1,1,1,1,1,1,0,0,0,1,1,1,1,1,1],
    [1,1,1,1,1,1,0,0,0,0,0,1,1,1,1],
    [1,1,1,0,1,1,0,0,0,0,0,0,1,1,1],
    [1,1,1,0,0,1,0,0,0,0,0,0,1,1,1],
    [1,1,1,0,0,0,0,0,0,0,0,0,1,1,1],
    [1,1,0,0,0,0,0,0,0,0,0,0,0,1,1],
    [1,1,0,0,0,0,0,0,0,0,0,0,0,1,1],
    [1,1,1,0,0,0,0,0,0,0,0,0,0,1,1],
    [1,1,1,0,0,0,0,0,0,0,0,0,0,0,1],
    [1,1,1,1,0,2,0,0,0,0,0,0,0,0,1],
    [1,1,1,1,1,1,1,1,1,1,1,1,1,1,1]
  ]
}