{
  "name": "5. Unstoppable",
  "rising_speed": 3,
  "environment": [
    [1,1,1,1,1,1,1,1,1,1,1,1,1,1,1],
    [1,0,0,0,0,0,0,0,0,0,0,0,0,0,1],
    [1,0,0,0,0,0,0,0,0,0,0,0,0,0,1],
    [1,0,0,0,3,0,0,0,0,0,0,0,0,0,1],
    [1,0,1,1,1,1,1,0,0,0,0,0,0,0,1],
    [1,0,1,1,1,1,1,0,0,0,1,1,1,0,1],
    [1,0,1,1,1,1,1,0,0,0,1,1,1,0,1],
    [1,0,1,1,1,1,1,0,0,1,1,1,1,0,1],
    [1,0,0,0,0,0,0,0,0,1,1,0,0,0,1],
    [1,0,0,0,0,0,0,0,0,0,0,0,0,0,1],
    [1,0,0,0,1,1,1,1,1,1,1,1,1,1,1],
    [1,0,0,0,1,1,1,1,1,1,1,1,1,1,1],
    [1,0,0,0,1,1,1,1,1,1,1,1,1,1,1],
    [1,1,0,0,1,1,1,1,1,1,1,1,1,1,1],
    [1,1,0,0,1,1,1,1,1,1,1,1,1,1,1],
    [1,1,0,0,1,1,1,1,1,1,1,1,1,1,1],
    [1,0,0,0,1,1,1,1,1,1,1,1,1,1,1],
    [1,0,0,0,0,0,0,0,0,0,0,0,0,0,1],
    [1,0,0,0,0,0,0,0,0,0,0,0,0,0,1],
    [1,0,0,0,0,0,1,1,1,1,1,0,0,0,1],
    [1,0,0,0,0,0,1,1,1,1,1,0,0,0,1],
    [1,0,0,0,0,0,1,1,1,1,1,0,0,0,1],
    [1,0,0,0,0,0,1,1,1,1,1,0,0,0,1],
    [1,0,0,0,0,0,1,1,1,1,1,1,0,0,1],
    [1,0,0,0,0,0,0,0,0,1,1,1,0,0,1],
    [1,0,0,0,0,0,0,0,0,0,0,0,0,0,1],
    [1,0,0,0,0,0,2,0,0,0,0,0,0,0,1],
    [1,1,1,1,1,1,1,1,1,1,1,1,1,1,1],
    [1,1,1,1,1,1,1,1,1,1,1,1,1,1,1],
    [1,1,1,1,1,1,1,1,1,1,1,1,1,1,1],
    [1,1,1,1,1,1,1,1,1,1,1,1,1,1,1]
  ]
}